1111111111111111111111111
10000000000000000000000B1
1000000000000000000000001
1000000000000000000000001
1000000000000000000000001
1000000000000000000000001
1000000000000000000000001
1000000000000000000000001
1000000000000000000000001
1000000000000000000000001
1000000000000000000000001
1000000000000000000000001
100000000000J000000000001
1000000000000000000000001
1000000000000000000000001
1B00000000000000000000001
1111111111111111111111111
